Tổng hợp Từ vựng & Ngữ pháp (Bài 1 - 15)
A Course in Contemporary Chinese 1
Bài 1: 歡迎你來臺灣！ (Hoan nghênh bạn đến Đài Loan!)
Từ vựng:
* 歡迎 (huānyíng) – Hoan nghênh
* 你 (nǐ) – Bạn
* 來 (lái) – Đến
* 臺灣 (Táiwān) – Đài Loan
* 請問 (qǐngwèn) – Xin hỏi
* 是 (shì) – Là
* 小姐 (xiǎojiě) – Cô, tiểu thư
* 嗎 (ma) – (Trợ từ nghi vấn) phải không?
* 謝謝 (xièxie) – Cảm ơn
* 接 (jiē) – Đón
* 我們 (wǒmen) – Chúng tôi, chúng ta
* 不客氣 (búkèqi) – Đừng khách sáo
* 我 (wǒ) – Tôi
* 這 (zhè) – Đây, này
* 先生 (xiānshēng) – Ông, ngài, tiên sinh
* 好 (hǎo) – Tốt, khỏe
* 姓 (xìng) – Mang họ, họ là
* 叫 (jiào) – Tên là, gọi là
* 你們 (nǐmen) – Các bạn
* 請 (qǐng) – Mời
* 喝 (hē) – Uống
* 茶 (chá) – Trà
* 很 (hěn) – Rất
* 好喝 (hǎohē) – Ngon (dùng cho đồ uống)
* 什麼 (shénme) – Cái gì
* 人 (rén) – Người
* 喜歡 (xǐhuān) – Thích
* 呢 (ne) – (Trợ từ nghi vấn) còn...thì sao?
* 他 (tā) – Anh ấy, ông ấy
* 不 (bù) – Không
* 哪 (nǎ) – Nào
* 要 (yào) – Muốn
* 咖啡 (kāfēi) – Cà phê
* 對不起 (duìbùqǐ) – Xin lỗi
* 國 (guó) – Nước, quốc gia
* 美國 (Měiguó) – Nước Mỹ
* 日本 (Rìběn) – Nhật Bản
* 烏龍茶 (Wūlóng chá) – Trà Ô Long
Ngữ pháp:
1. Các cách đặt câu hỏi:
   * A-not-A (Chính-Phản): Động từ/Tính từ + 不 + Động từ/Tính từ? (Ví dụ: 你是不是臺灣人？ - Nǐ shì bú shì Táiwān rén?)
   * Với 嗎 (ma): Câu trần thuật + 嗎? (Ví dụ: 你是臺灣人嗎？ - Nǐ shì Táiwān rén ma?)
2. Cách trả lời câu hỏi:
   * Khẳng định: Lặp lại động từ chính. (Ví dụ: A: 你喜歡臺灣嗎？ B: 喜歡。)
   * Phủ định: Dùng 不 + Động từ. (Ví dụ: A: 你喝咖啡嗎？ B: 不喝。)
3. Phó từ chỉ mức độ 很 (hěn): Thường đứng trước tính từ để bổ nghĩa. (Ví dụ: 很好 - hěn hǎo - rất tốt).
4. Câu hỏi tỉnh lược với 呢 (ne): Dùng để hỏi lại về một đối tượng khác trong cùng một ngữ cảnh. (Ví dụ: 我喝茶，你呢？- Wǒ hē chá, nǐ ne? - Tôi uống trà, còn bạn thì sao?).
Bài 2: 我的家人 (Gia đình của tôi)
Từ vựng:
* 的 (de) – Của
* 家 (jiā) – Nhà, gia đình
* 家人 (jiārén) – Người nhà
* 漂亮 (piàoliàng) – Xinh đẹp
* 房子 (fángzi) – Ngôi nhà
* 坐 (zuò) – Ngồi
* 有 (yǒu) – Có
* 多 (duō) – Nhiều
* 照片 (zhàopiàn) – Bức ảnh
* 都 (dōu) – Đều
* 照相 (zhàoxiàng) – Chụp ảnh
* 張 (zhāng) – (Lượng từ) tấm, tờ
* 好看 (hǎokàn) – Đẹp, ưa nhìn
* 誰 (shéi) – Ai
* 姐姐 (jiějie) – Chị gái
* 妹妹 (mèimei) – Em gái
* 爸爸 (bàba) – Bố
* 媽媽 (māma) – Mẹ
* 請進 (qǐng jìn) – Mời vào
* 伯母 (bómǔ) – Bác gái
* 您 (nín) – Ngài, ông, bà (kính trọng)
* 名字 (míngzi) – Tên
* 書 (shū) – Sách
* 哥哥 (gēge) – Anh trai
* 老師 (lǎoshī) – Giáo viên
* 看書 (kànshū) – Đọc sách
* 幾 (jǐ) – Mấy
* 個 (ge) – (Lượng từ) cái, người
* 沒 (méi) – Không (dùng với 有)
* 兄弟 (xiōngdì) – Anh em trai
* 姐妹 (jiěmèi) – Chị em gái
* 五 (wǔ) – Năm (số 5)
* 兩 (liǎng) – Hai (dùng trước lượng từ)
Ngữ pháp:
1. Sở hữu cách với 的 (de): Chủ sở hữu + 的 + Vật sở hữu. (Ví dụ: 我的書 - wǒ de shū - sách của tôi).
2. Định ngữ với 的 (de): Định ngữ + 的 + Danh từ. (Ví dụ: 漂亮的房子 - piàoliàng de fángzi - ngôi nhà xinh đẹp).
3. Câu tồn tại với 有 (yǒu): Địa điểm + 有 + Sự vật. (Ví dụ: 我家有很多照片 - wǒ jiā yǒu hěn duō zhàopiàn).
4. Phó từ 都 (dōu): Biểu thị "tất cả", "đều". Thường đứng trước động từ. (Ví dụ: 我們都是學生 - wǒmen dōu shì xuéshēng).
5. Lượng từ: Số từ + Lượng từ + Danh từ. (Ví dụ: 一張照片 - yì zhāng zhàopiàn; 兩個人 - liǎng ge rén).
Bài 3: 週末做什麼？ (Cuối tuần làm gì?)
Từ vựng:
* 週末 (zhōumò) – Cuối tuần
* 聽 (tīng) – Nghe
* 音樂 (yīnyuè) – Âm nhạc
* 運動 (yùndòng) – Vận động, thể thao
* 打 (dǎ) – Chơi, đánh (thể thao dùng tay)
* 網球 (wǎngqiú) – Quần vợt
* 棒球 (bàngqiú) – Bóng chày
* 和 (hàn) – Và
* 游泳 (yóuyǒng) – Bơi lội
* 常 (cháng) – Thường xuyên
* 籃球 (lánqiú) – Bóng rổ
* 也 (yě) – Cũng
* 踢 (tī) – Đá (bóng)
* 足球 (zúqiú) – Bóng đá
* 覺得 (juéde) – Cảm thấy
* 好玩 (hǎowán) – Vui, thú vị
* 明天 (míngtiān) – Ngày mai
* 早上 (zǎoshàng) – Buổi sáng
* 去 (qù) – Đi
* 怎麼樣 (zěnmeyàng) – Như thế nào?
* 啊 (a) – (Trợ từ cuối câu)
* 看 (kàn) – Xem
* 電影 (diànyǐng) – Phim điện ảnh
* 妳 (nǐ) – Bạn (dùng cho nữ)
* 想 (xiǎng) – Muốn, nghĩ
* 還是 (háishì) – Hay là (dùng trong câu hỏi lựa chọn)
* 吧 (ba) – (Trợ từ cuối câu, biểu thị sự đề nghị)
* 可以 (kěyǐ) – Có thể
* 學 (xué) – Học
* 中文 (Zhōngwén) – Tiếng Trung
* 一起 (yìqǐ) – Cùng nhau
* 吃 (chī) – Ăn
* 晚飯 (wǎnfàn) – Bữa tối
* 菜 (cài) – Món ăn, rau
* 越南 (Yuènán) – Việt Nam
Ngữ pháp:
1. Vị trí của từ chỉ thời gian: Thường đứng sau chủ ngữ và trước động từ. (Ví dụ: 我們明天去看電影).
2. Đi làm gì với 去 (qù): 去 + Động từ. (Ví dụ: 我去打網球 - Wǒ qù dǎ wǎngqiú).
3. Câu chủ đề: Đưa đối tượng muốn bình luận lên đầu câu làm chủ đề. (Ví dụ: 美國電影、臺灣電影，我都想看).
4. Trật tự phó từ 也 (yě), 都 (dōu): 也 thường đứng trước 都 và 常. (Ví dụ: 我常打籃球，也常踢足球).
5. Đưa ra đề nghị với 吧 (ba): Câu trần thuật + 吧!. (Ví dụ: 我們看臺灣電影吧!).
(Các bài học tiếp theo sẽ được cập nhật tương tự...)
Bài 4: 請問一共多少錢？ (Xin hỏi tổng cộng bao nhiêu tiền?)
Từ vựng:
* 一共 (yígòng) – Tổng cộng
* 多少 (duōshǎo) – Bao nhiêu
* 錢 (qián) – Tiền
* 老闆 (lǎobǎn) – Ông chủ
* 買 (mǎi) – Mua
* 杯 (bēi) – Cốc, ly (lượng từ)
* 熱 (rè) – Nóng
* 包子 (bāozi) – Bánh bao
* 大 (dà) – To, lớn
* 中 (zhōng) – Vừa (size)
* 小 (xiǎo) – Nhỏ
* 幫 (bāng) – Giúp đỡ
* 微波 (wéibō) – Vi sóng
* 百 (bǎi) – Trăm
* 塊 (kuài) – Đồng (tiền tệ)
* 外帶 (wàidài) – Mang đi
* 內用 (nèiyòng) – Dùng tại chỗ
* 支 (zhī) – Chiếc (lượng từ cho vật dài, cứng như bút, điện thoại)
* 新 (xīn) – Mới
* 手機 (shǒujī) – Điện thoại di động
* 太 (tài) – Quá
* 舊 (jiù) – Cũ
* 了 (le) – (Trợ từ cuối câu)
* 種 (zhǒng) – Loại, chủng loại
* 能 (néng) – Có thể (về khả năng)
* 上網 (shàngwǎng) – Lên mạng
* 那 (nà) – Kia, đó
* 貴 (guì) – Đắt
* 賣 (mài) – Bán
* 便宜 (piányí) – Rẻ
* 萬 (wàn) – Vạn (mười nghìn)
* 千 (qiān) – Nghìn
* 為什麼 (wèishénme) – Tại sao
Ngữ pháp:
1. Lượng từ: 塊 (kuài), 杯 (bēi), 支 (zhī), 種 (zhǒng).
2. Giới từ 幫 (bāng): 幫 + Tân ngữ chỉ người + Động từ. (Ví dụ: 請幫我微波包子 - Mời giúp tôi vi sóng bánh bao).
3. Lược bỏ Danh từ trung tâm sau 的 (de): Khi danh từ đã rõ, có thể lược bỏ. (Ví dụ: 我要新的 (手機)).
4. Cấu trúc 太...了 (tài...le): Biểu thị mức độ quá cao. (Ví dụ: 太貴了 - tài guì le - Đắt quá).
5. Động từ năng nguyện 能 (néng): Biểu thị khả năng. (Ví dụ: 手機能上網).
6. 多 (duō) chỉ số lượng "hơn": Số từ + 多 + Lượng từ + Danh từ. (Ví dụ: 一萬五千多塊 - Hơn 15000 đồng).
Bài 5: 牛肉麵真好吃 (Mì bò thật ngon)
Từ vựng:
* 牛肉 (niúròu) – Thịt bò
* 麵 (miàn) – Mì
* 真 (zhēn) – Thật là
* 好吃 (hǎochī) – Ngon (dùng cho đồ ăn)
* 說 (shuō) – Nói
* 少 (shǎo) – Ít
* 有名 (yǒumíng) – Nổi tiếng
* 小吃 (xiǎochī) – Món ăn vặt, quà vặt
* 最 (zuì) – Nhất
* 湯 (tāng) – Canh, súp
* 這麼 (zhème) – Như vậy
* 知道 (zhīdào) – Biết
* 家 (jiā) – (Lượng từ) cho cửa hàng, nhà hàng
* 店 (diàn) – Cửa hàng
* 一定 (yídìng) – Nhất định
* 點 (diǎn) – Gọi món
* 碗 (wǎn) – Bát, chén (lượng từ)
* 小籠包 (xiǎolóngbāo) – Tiểu long bao
* 臭豆腐 (chòudòufu) – Đậu phụ thối
* 昨天 (zuótiān) – Hôm qua
* 餐廳 (cāntīng) – Nhà hàng
* 可是 (kěshì) – Nhưng
* 辣 (là) – Cay
* 怕 (pà) – Sợ
* 所以 (suǒyǐ) – Cho nên
* 自己 (zìjǐ) – Tự mình
* 做飯 (zuòfàn) – Nấu cơm
* 得 (de) – (Bổ ngữ trạng thái)
* 會 (huì) – Biết (thông qua học tập)
* 甜點 (tiándiǎn) – Đồ ngọt, tráng miệng
* 不錯 (búcuò) – Không tệ, tốt
* 教 (jiāo) – Dạy
* 到 (dào) – Đến
Ngữ pháp:
1. 有一點 (yǒu yìdiǎn): 有一點 + Tính từ, biểu thị một chút (thường mang nghĩa tiêu cực). (Ví dụ: 有一點辣 - hơi cay một chút).
2. Bổ ngữ trạng thái 得 (de): Động từ + 得 + Tính từ/Trạng từ để miêu tả trạng thái của hành động. (Ví dụ: 他做得很好 - Anh ấy làm rất tốt).
3. Động từ năng nguyện 會 (huì): Biểu thị kỹ năng có được qua học tập. (Ví dụ: 我會做飯 - Tôi biết nấu cơm).
4. Giới từ 到 (dào): Biểu thị điểm đến. (Ví dụ: 你到我家來 - Bạn đến nhà tôi đi).
Bài 6: 他們學校在山上 (Trường họ ở trên núi)
Từ vựng:
* 他們 (tāmen) – Bọn họ
* 學校 (xuéxiào) – Trường học
* 在 (zài) – Ở tại
* 山上 (shānshàng) – Trên núi
* 哪裡 (nǎlǐ) – Ở đâu
* 遠 (yuǎn) – Xa
* 那裡 (nàlǐ) – Ở đó
* 風景 (fēngjǐng) – Phong cảnh
* 美 (měi) – Đẹp
* 前面 (qiánmiàn) – Phía trước
* 海 (hǎi) – Biển
* 後面 (hòumiàn) – Phía sau
* 山 (shān) – Núi
* 真的 (zhēnde) – Thật sự
* 地方 (dìfang) – Nơi, chỗ
* 現在 (xiànzài) – Bây giờ
* 附近 (fùjìn) – Gần đây, lân cận
* 樓下 (lóuxià) – Dưới lầu
* 找 (zhǎo) – Tìm
* 朋友 (péngyou) – Bạn bè
* 上課 (shàngkè) – Lên lớp, đi học
* 近 (jìn) – Gần
* 方便 (fāngbiàn) – Thuận tiện
* 東西 (dōngxi) – Đồ đạc
* 外面 (wàimiàn) – Bên ngoài
* 裡面 (lǐmiàn) – Bên trong
* 商店 (shāngdiàn) – Cửa hàng
* 宿舍 (sùshè) – Ký túc xá
* 樓 (lóu) – Tầng, lầu
* 棟 (dòng) – Tòa (lượng từ cho tòa nhà)
* 大樓 (dàlóu) – Tòa nhà lớn
* 圖書館 (túshūguǎn) – Thư viện
* 旁邊 (pángbiān) – Bên cạnh
* 教室 (jiàoshì) – Phòng học
* 游泳池 (yóuyǒngchí) – Bể bơi
Ngữ pháp:
1. Biểu thị vị trí với 在 (zài): Sự vật + 在 + Địa điểm.
2. Câu tồn tại với 有 (yǒu): Địa điểm + 有 + Sự vật.
3. Lặp lại động từ (V-V): Biểu thị hành động diễn ra trong thời gian ngắn, thử làm gì đó. (Ví dụ: 我想去看看 - Wǒ xiǎng qù kànkan).
4. Phủ định với 不是 (búshì): Dùng để phủ nhận một sự thật hoặc một nhận định đã nêu.
5. Vị trí của hành động: Chủ ngữ + 在 + Địa điểm + Động từ. (Ví dụ: 我在家看書 - Wǒ zài jiā kàn shū).
Bài 7: 早上九點去KTV (9 giờ sáng đi KTV)
Từ vựng:
* 點 (diǎn) – Giờ (chỉ thời gian)
* KTV (Karaoke)
* 唱歌 (chànggē) – Hát
* 分 (fēn) – Phút
* 見面 (jiànmiàn) – Gặp mặt
* 從 (cóng) – Từ
* 中午 (zhōngwǔ) – Buổi trưa
* 得 (děi) – Phải (làm gì)
* 銀行 (yínháng) – Ngân hàng
* 時候 (shíhou) – Lúc, khi
* 後天 (hòutiān) – Ngày kia
* 再見 (zàijiàn) – Tạm biệt
* 午餐 (wǔcān) – Bữa trưa
* 剛 (gāng) – Vừa mới
* 下課 (xiàkè) – Tan học
* 下午 (xiàwǔ) – Buổi chiều
* 半 (bàn) – Rưỡi, nửa
* 比賽 (bǐsài) – Cuộc thi, trận đấu
* 結束 (jiéshù) – Kết thúc
* 最近 (zuìjìn) – Gần đây
* 忙 (máng) – Bận rộn
* 每 (měi) – Mỗi
* 天 (tiān) – Ngày
* 書法 (shūfǎ) – Thư pháp
* 課 (kè) – Môn học, bài học
* 開始 (kāishǐ) – Bắt đầu
* 字 (zì) – Chữ
* 寫 (xiě) – Viết
* 問 (wèn) – Hỏi
Ngữ pháp:
1. Thứ tự thời gian và địa điểm: Chủ ngữ + Thời gian + Địa điểm + Động từ.
2. Cấu trúc 從...到... (cóng...dào...): Từ...đến... (chỉ không gian hoặc thời gian).
3. Hành động tiếp diễn với 在 (zài): 在 + Động từ, biểu thị hành động đang diễn ra.
4. 每 (měi): Mỗi, thường đi kèm với 都 (dōu). (Ví dụ: 我每天都運動).
5. 可以 (kěyǐ): Có thể (xin phép).
Bài 8: 坐火車去臺南 (Ngồi tàu hỏa đi Đài Nam)
Từ vựng:
* 坐 (zuò) – Ngồi (phương tiện)
* 火車 (huǒchē) – Tàu hỏa
* 跟 (gēn) – Cùng với
* 玩 (wán) – Chơi
* 怎麼 (zěnme) – Như thế nào, làm sao
* 慢 (màn) – Chậm
* 鐘頭 (zhōngtóu) – Tiếng, giờ (khoảng thời gian)
* 比較 (bǐjiào) – Tương đối, hơn
* 快 (kuài) – Nhanh
* 車票 (chēpiào) – Vé xe
* 非常 (fēicháng) – Vô cùng, rất
* 但是 (dànshì) – Nhưng
* 又...又... (yòu...yòu...) – Vừa...vừa...
* 舒服 (shūfu) – Thoải mái
* 站 (zhàn) – Trạm, ga
* 或是 (huòshì) – Hoặc là
* 同學 (tóngxué) – Bạn học
* 參觀 (cānguān) – Tham quan
* 古代 (gǔdài) – Cổ đại
* 騎 (qí) – Cưỡi, đi (xe 2 bánh)
* 機車 (jīchē) – Xe máy
* 載 (zài) – Chở, đèo
* 捷運 (jiéyùn) – Tàu điện ngầm (MRT)
* 比 (bǐ) – So với (dùng trong câu so sánh)
* 故宮 (Gùgōng) – Cố Cung
Ngữ pháp:
1. Đi cùng ai với 跟 (gēn): A 跟 B 一起 + Động từ.
2. Hỏi cách thức với 怎麼 (zěnme): 怎麼 + Động từ?.
3. So sánh ngầm với 比較 (bǐjiào): Biểu thị mức độ "hơn". (Ví dụ: 這個比較好).
4. Cấu trúc 又...又... (yòu...yòu...): Biểu thị hai đặc điểm/hành động cùng tồn tại.
5. Câu so sánh với 比 (bǐ): A 比 B + Tính từ.
Bài 9: 放假去哪裡玩？ (Nghỉ lễ đi đâu chơi?)
Từ vựng:
* 放假 (fàngjià) – Nghỉ lễ, nghỉ phép
* 星期 (xīngqī) – Tuần
* 回國 (huíguó) – Về nước
* 打算 (dǎsuàn) – Dự định
* 電視 (diànshì) – Ti vi
* 影片 (yǐngpiàn) – Phim, video
* 旅行 (lǚxíng) – Du lịch
* 功課 (gōngkè) – Bài tập về nhà
* 出去 (chūqù) – Đi ra ngoài
* 大概 (dàgài) – Khoảng, đại khái
* 有時候 (yǒushíhou) – Có lúc, thỉnh thoảng
* 多久 (duō jiǔ) – Bao lâu
* 女 (nǚ) – Nữ
* 月 (yuè) – Tháng
* 號 (hào) – Ngày
* 帶 (dài) – Mang, dắt
* 她 (tā) – Cô ấy
* 還 (hái) – Vẫn, còn
* 建議 (jiànyì) – Gợi ý, đề nghị
* 夜市 (yèshì) – Chợ đêm
* 應該 (yīnggāi) – Nên
* 逛 (guàng) – Dạo chơi
* 特別 (tèbié) – Đặc biệt
* 茶館 (cháguǎn) – Quán trà
* 決定 (juédìng) – Quyết định
* 要是 (yàoshi) – Nếu
* 就 (jiù) – Thì, liền
Ngữ pháp:
1. Phân biệt Thời điểm và Thời đoạn: Thời điểm (time-when) chỉ một mốc thời gian. Thời đoạn (time-duration) chỉ một khoảng thời gian.
2. Cấu trúc ...的時候 (de shíhou): Khi... (Ví dụ: 放假的時候 - Lúc nghỉ lễ).
3. Cấu trúc 有時候...有時候...: Lúc thì... lúc thì...
4. Câu điều kiện 要是...就... (yàoshi...jiù...): Nếu...thì...
Bài 10: 臺灣的水果很好吃 (Trái cây Đài Loan rất ngon)
Từ vựng:
* 水果 (shuǐguǒ) – Trái cây
* 黃色 (huángsè) – Màu vàng
* 芒果 (mángguǒ) – Xoài
* 給 (gěi) – Cho
* 塊 (kuài) – Miếng (lượng từ)
* 香 (xiāng) – Thơm
* 甜 (tián) – Ngọt
* 紅色 (hóngsè) – Màu đỏ
* 西瓜 (xīguā) – Dưa hấu
* 吧 (ba) – (Trợ từ cuối câu, biểu thị sự phỏng đoán)
* 對 (duì) – Đúng
* 以前 (yǐqián) – Trước đây
* 機會 (jīhuì) – Cơ hội
* 請 (qǐng) – Mời (ai đó ăn/uống)
* 拍 (pāi) – Chụp (ảnh)
* 笑 (xiào) – Cười
* 開心 (kāixīn) – Vui vẻ
* 穿 (chuān) – Mặc (quần áo)
* 衣服 (yīfu) – Quần áo
* 旅館 (lǚguǎn) – Khách sạn
* 太太 (tàitai) – Vợ, bà (madam)
* 男 (nán) – Nam
* 矮 (ǎi) – Thấp, lùn
* 高 (gāo) – Cao
* 弟弟 (dìdi) – Em trai
* 乾淨 (gānjìng) – Sạch sẽ
* 窗戶 (chuānghu) – Cửa sổ
* 往 (wǎng) – Hướng về
* 藍色 (lánsè) – Màu xanh lam
* 因為 (yīnwèi) – Bởi vì
* 住 (zhù) – Sống, ở
Ngữ pháp:
1. Lặp lại động từ + 看 (VVkàn): Thử làm gì đó xem sao. (Ví dụ: 吃吃看 - chīchīkàn).
2. Lặp lại tính từ (AA的): Nhấn mạnh tính chất, thường mang sắc thái yêu thích, khen ngợi. (Ví dụ: 香香的，甜甜的).
3. Mệnh đề làm định ngữ: Mệnh đề + 的 + Danh từ. (Ví dụ: 你說的水果 - trái cây mà bạn nói).
4. Trợ từ 了 (le) cuối câu: Biểu thị sự thay đổi của tình huống. (Ví dụ: 我現在很喜歡了 - bây giờ tôi rất thích rồi).
5. Câu nguyên nhân - kết quả 因為...所以...: Bởi vì... cho nên...
Bài 11: 我要租房子 (Tôi muốn thuê nhà)
Từ vựng:
* 租 (zū) – Thuê
* 房東 (fángdōng) – Chủ nhà
* 客廳 (kètīng) – Phòng khách
* 廚房 (chúfáng) – Nhà bếp
* 左邊 (zuǒbiān) – Bên trái
* 右邊 (yòubiān) – Bên phải
* 浴室 (yùshì) – Phòng tắm
* 超市 (chāoshì) – Siêu thị
* 走路 (zǒulù) – Đi bộ
* 分鐘 (fēnzhōng) – Phút
* 到 (dào) – Đến
* 間 (jiān) – Gian (lượng từ cho phòng)
* 空 (kōng) – Trống
* 房間 (fángjiān) – Căn phòng
* 套房 (tàofáng) – Phòng khép kín
* 回去 (huíqù) – Đi về
* 再 (zài) – Lại, nữa, sau đó
* 電話 (diànhuà) – Điện thoại
* 喂 (wéi) – A lô
* 房租 (fángzū) – Tiền thuê nhà
* 已經 (yǐjīng) – Đã
* 習慣 (xíguàn) – Quen
* 問題 (wèntí) – Vấn đề
* 熱水器 (rèshuǐqì) – Bình nóng lạnh
* 好像 (hǎoxiàng) – Hình như
* 會 (huì) – Sẽ
* 等 (děng) – Đợi
* 那 (nà) – Vậy thì, thế thì
* 裝 (zhuāng) – Lắp đặt
* 不過 (búguò) – Nhưng
* 付 (fù) – Trả (tiền)
Ngữ pháp:
1. Đến để làm gì với 來 (lái): 來 + Động từ. (Ví dụ: 我來看房子 - Tôi đến xem nhà).
2. 就 (jiù) - Sớm hơn dự kiến: (Ví dụ: 走路五分鐘就到了 - Đi bộ 5 phút là đến rồi).
3. Câu tồn tại với chủ ngữ bất định: 有 + Danh từ bất định + Động từ. (Ví dụ: 有人住嗎？).
4. Các loại 會 (huì): huì_1 (kỹ năng), huì_2 (khả năng xảy ra, sẽ).
5. Lược bỏ danh từ: Trong văn nói, danh từ đã được nhắc đến hoặc rõ ràng trong ngữ cảnh thường được lược bỏ.
Bài 12: 你在臺灣學多久的中文？ (Bạn học tiếng Trung ở Đài Loan bao lâu?)
Từ vựng:
* 計畫 (jìhuà) – Kế hoạch, dự định
* 年 (nián) – Năm
* 久 (jiǔ) – Lâu
* 時間 (shíjiān) – Thời gian
* 先 (xiān) – Trước
* 念 (niàn) – Học, đọc
* 大學 (dàxué) – Đại học
* 需要 (xūyào) – Cần
* 花 (huā) – Tiêu tốn (thời gian, tiền bạc)
* 獎學金 (jiǎngxuéjīn) – Học bổng
* 成績 (chéngjì) – Thành tích, điểm số
* 學費 (xuéfèi) – Học phí
* 公司 (gōngsī) – Công ty
* 替 (tì) – Thay, cho
* 希望 (xīwàng) – Hy vọng
* 以後 (yǐhòu) – Sau này
* 上班 (shàngbān) – Đi làm
* 念書 (niànshū) – Học bài, đi học
* 累 (lèi) – Mệt
* 工作 (gōngzuò) – Công việc, làm việc
* 去年 (qùnián) – Năm ngoái
* 做 (zuò) – Làm
* 生意 (shēngyì) – Kinh doanh
* 好 (hǎo) – Dễ (làm gì)
* 難 (nán) – Khó (làm gì)
* 這樣 (zhèyàng) – Như thế này
* 國家 (guójiā) – Đất nước
* 試 (shì) – Thử
Ngữ pháp:
1. Cấu trúc 先...再... (xiān...zài...): Trước tiên...sau đó...
2. Nhấn mạnh với 是...的 (shì...de): Dùng để nhấn mạnh một thành phần (thời gian, địa điểm, cách thức...) của hành động đã xảy ra trong quá khứ.
3. 以後 (yǐhòu): Sau này, sau khi.
4. Nghĩa đặc biệt của 好/難 + Động từ: 好 là dễ, 難 là khó. (Ví dụ: 中文不好學 - Tiếng Trung không dễ học).
Bài 13: 生日快樂 (Chúc mừng sinh nhật)
Từ vựng:
* 生日 (shēngrì) – Sinh nhật
* 快樂 (kuàilè) – Vui vẻ
* 回來 (huílái) – Quay về
* 啊 (a) – (Trợ từ thán từ)
* 怎麼 (zěnme) – Sao lại, làm sao
* 忘了 (wàngle) – Quên rồi
* 記得 (jìde) – Nhớ
* 當然 (dāngrán) – Đương nhiên
* 語言 (yǔyán) – Ngôn ngữ
* 交換 (jiāohuàn) – Trao đổi
* 那麼 (nàme) – Như vậy, đến thế
* 熱心 (rèxīn) – Nhiệt tình
* 西班牙文 (Xībānyáwén) – Tiếng Tây Ban Nha
* 一樣 (yíyàng) – Giống nhau
* 過 (guò) – Trải qua, đón (sinh nhật)
* 左右 (zuǒyòu) – Khoảng
* 門口 (ménkǒu) – Cổng
* 禮物 (lǐwù) – Quà
* 今年 (jīnnián) – Năm nay
* 訂 (dìng) – Đặt trước
* 了 (le) – (Trợ từ động thái, hoàn thành)
* 豬腳麵線 (zhūjiǎo miànxiàn) – Mì sợi heo
* 蛋 (dàn) – Trứng
* 一點 (yìdiǎn) – Một chút
* 傳統 (chuántǒng) – Truyền thống
* 年輕 (niánqīng) – Trẻ
* 蛋糕 (dàngāo) – Bánh ngọt
* 對 (duì) – Đối với
* 祝 (zhù) – Chúc
Ngữ pháp:
1. Cấu trúc 一...就... (yī...jiù...): Hễ...là...
2. Động thái từ 了 (le): Đứng sau động từ, biểu thị hành động đã hoàn thành.
3. Phân biệt phủ định 不 và 沒: 不 dùng cho hiện tại, tương lai, thói quen; 沒 dùng cho quá khứ và phủ định của 有.
4. Câu bao hàm với từ nghi vấn: Từ nghi vấn + 都/也 + Phủ định/Khẳng định. (Ví dụ: 我什麼都吃 - Tôi ăn gì cũng được).
5. 多/少 + Động từ: Làm gì đó nhiều hơn/ít hơn.
6. 是不是 (shì bú shì): Dùng để xác nhận thông tin.
7. So sánh với 跟...一樣...: A 跟 B 一樣 (+ tính từ) - A giống B.
Bài 14: 天氣這麼冷！ (Thời tiết lạnh quá!)
Từ vựng:
* 天氣 (tiānqì) – Thời tiết
* 冷 (lěng) – Lạnh
* 風 (fēng) – Gió
* 滑雪 (huáxuě) – Trượt tuyết
* 春天 (chūntiān) – Mùa xuân
* 想 (xiǎng) – Nhớ
* 新年 (xīnnián) – Năm mới
* 快 (kuài) – Sắp
* 父母 (fùmǔ) – Bố mẹ
* 冬天 (dōngtiān) – Mùa đông
* 明年 (míngnián) – Năm sau
* 秋天 (qiūtiān) – Mùa thu
* 紅葉 (hóngyè) – Lá đỏ
* 只 (zhǐ) – Chỉ
* 下雪 (xiàxuě) – Tuyết rơi
* 雨 (yǔ) – Mưa
* 傘 (sǎn) – Ô, dù
* 颱風 (táifēng) – Bão
* 要 (yào) – Sẽ
* 夏天 (xiàtiān) – Mùa hè
* 濕 (shī) – Ẩm ướt
* 討厭 (tǎoyàn) – Ghét
* 新聞 (xīnwén) – Tin tức
* 更 (gèng) – Càng
* 大家 (dàjiā) – Mọi người
* 小心 (xiǎoxīn) – Cẩn thận
* 可怕 (kěpà) – Đáng sợ
* 停 (tíng) – Dừng
Ngữ pháp:
1. Thời đoạn sau Động từ + 了: Biểu thị thời gian kéo dài của hành động đã hoàn thành. (Ví dụ: 我在臺灣住了一年).
2. Cấu trúc "了" kép: V + 了 + Thời đoạn + 了, biểu thị hành động đã diễn ra được một khoảng thời gian và vẫn có thể tiếp tục.
3. Cấu trúc 快...了 (kuài...le): Sắp...rồi.
4. So sánh với 更 (gèng): Càng... (Ví dụ: 今天比昨天更冷).
5. So sánh kém hơn với 沒有 (méiyǒu): A 沒有 B + Tính từ.
Bài 15: 我很不舒服 (Tôi rất khó chịu)
Từ vựng:
* 醫生 (yīshēng) – Bác sĩ
* 一直 (yìzhí) – Liên tục, suốt
* 流 (liú) – Chảy
* 鼻水 (bíshuǐ) – Nước mũi
* 頭 (tóu) – Đầu
* 痛 (tòng) – Đau
* 胃口 (wèikǒu) – Khẩu vị
* 差 (chà) – Kém
* 喉嚨 (hóulóng) – Họng
* 發炎 (fāyán) – Viêm
* 生病 (shēngbìng) – Bị bệnh
* 發燒 (fāshāo) – Sốt
* 感冒 (gǎnmào) – Cảm cúm
* 藥 (yào) – Thuốc
* 藥局 (yàojú) – Hiệu thuốc
* 拿 (ná) – Cầm, lấy
* 把 (bǎ) – (Giới từ trong câu chữ 把)
* 水 (shuǐ) – Nước
* 休息 (xiūxi) – Nghỉ ngơi
* 睡覺 (shuìjiào) – Ngủ
* 臉色 (liǎnsè) – Sắc mặt
* 難看 (nánkàn) – Khó coi, xấu xí
* 肚子 (dùzi) – Bụng
* 吐 (tù) – Nôn
* 次 (cì) – Lần
* 陪 (péi) – Đi cùng, ở bên
* 看病 (kànbìng) – Khám bệnh
* 健康 (jiànkāng) – Sức khỏe
* 保險 (bǎoxiǎn) – Bảo hiểm
* 油 (yóu) – Dầu mỡ
* 冰 (bīng) – Lạnh, đá
* 別 (bié) – Đừng
* 關心 (guānxīn) – Quan tâm
* 包 (bāo) – Gói (lượng từ)
* 睡 (shuì) – Ngủ
* 小時 (xiǎoshí) – Giờ, tiếng đồng hồ
Ngữ pháp:
1. Câu biểu thị thái độ không chắc chắn với từ nghi vấn: Thường dùng ở dạng phủ định. (Ví dụ: 我沒有多少錢 - Tôi không có bao nhiêu tiền).
2. Câu chữ 把 (bǎ): Chủ ngữ + 把 + Tân ngữ + Động từ + Thành phần khác, nhấn mạnh sự xử lý đối với tân ngữ.
3. Cấu trúc V了...就... (V le...jiù...): Làm xong V rồi thì...
4. 一點 (yìdiǎn): Một chút (có nhiều cách dùng khác nhau).
5. So sánh hành động với bổ ngữ 得: Động từ + 得 + 比 + Đối tượng so sánh + Tính từ.
6. Động từ ly hợp: Các động từ có cấu trúc Động-Tân có thể tách ra để chèn các thành phần khác vào giữa. (Ví dụ: 見面 -> 見個面).